NO ./textures/Bark.png
SO ./textures/Bricks.png
WE ./textures/Dirt.png
EA ./textures/Coal.png

F 220,100,0
C 225,30,0

111111111111111111111111111111
1000N0000000000000000000000001
101111111110111111111110111101
101000000010000000000010000101
101011111010111111111010111101
101010001010100000001010100001
101010111010101111101010111111
101010000010101000001010000001
101011111110101011111011111101
101000000000101000001000000001
111111111111111111111111111111
