NO ./textures/predatel.png
SO ./textures/lov66.png
WE ./textures/flex.png
EA ./textures/vitaminka.png

F 220,100, 99
C 225,30,0
waerstdyfughjklhgfdfxgchvj
        1111111111111111111111111
        1000000000110000000000001
        1011000001110000000000001
        100100000000000000N000001
111111111011000001110000000000001
100000000011000001110111111111111
11110111111111011100000010001
11110111111111011101010010001
11000000110101011100000010001
10000000000000001100000010001111111111
100000000000000011010100100000000000001
11000001110101011111011110001111111111
11110111111101011101111010001
11111111 111111 111111111111