NO ./textures/Bark.png
SO ./textures/Bricks.png
WE ./textures/Dirt.png
EA ./textures/Coal.png

F 20,100,20
C 25,30,200

111111111111111111111111111111
100001000000000000010000000001
100001000000000000010000000001
100000000000000000010000000001
111111000000000000010011111111
100000000000000000000011111111
100000000000000000000010000001
100000000000000N00000010000001
100000000000000000000000000001
100000000000000000000000000001
111111111111111111111111111111
