NO ./textures/Bark.png
SO ./textures/Bricks.png
WE ./textures/Dirt.png
EA ./textures/Coal.png

F 108,212,21
C 90,34,222

111111111111111111111111111111
100000000000000000000000000001
100000000000000000000000000001
100000000000000000000000000001
100000000000000000000000000001
100000000000000000000000000001
100000000000000000000000000001
100000000000000N00000000000001
100000000000000000000000000001
100000000000000000000000000001
111111111111111111111111111111
